111111 11111
            
111211121111
            
11 111 1 11 
2         2
11  11   111
11         1
1111  111  1
 11    21 11
11111  11 11
1111  11  11
111  11  111
111 1111  11
111 1111 111
1   2111   1
1  111111  1
1    12    1
111 111 1111
111     1111
111  1  1111
111 111 1111
11  111  111
11 11111 111
11 11111 111
11  111  111
111 212 1111
11  111  111
11 11111 111
11  111  111
111 111 1111
111  2  1111
111 111 1111
111 111 1111
111 111 1111
111  1  1111
1111 2 11111
11   1   111
1   111   11
1  11111  11
1 1111111  1
1  11111  11
11 21112 111
1  11111   1
1 1111111  1
1  11111   1
1   111   11
11   1   111
1111   11111
1111    1111
111111  1111
1111    1111
111  1111111
111  1111111
111     1111
111 211 1111
111  12 1111
111     1111
111  11  111
111  112 111
111      111
111 211  111
111  11  111
111  11  211
111  11   11
111 1111  11
11  1111   1
11 111111  1
11 111111  1
112  1111121
1111 11    1
1111 11 1111
1111 11 1111
1111    1111
1111  111111
1111   11111
1111 1111111
1111  111111
11111  21111
11111 111111
11111 111111
11111 111111
11111 111111
1112  111111
111  1111111
111  2 11111
1111 1 11111
1111 1 11111
1111 2 11111
11111  11111
11111  11111
11111  11111
111111 11111
111111 11111
11112  11111
1111   11111
1111112 1111
1111111 1111
1111111 1111
1111111   11
1111111 1 11
11111   1 11
11111 111 11
111     1211
111211    11
111  2  1211
111 111 1 11
111 111 1 11
111  1  1 11
111  1  1 11
1111 1 11 11
1111 2 11211
11111 111 11
11111     11
11111 111111
11111 111111
11111 111111
111   111111
111  1111111
111  1111111
1111  111111
1111  111111
11111 111111
11111  11111
1111   2 111
111   11 111
111 1  1 111
111211 12111
111      111
11111  11111
1111    1111
1111 11 1111
1111    1111
11111  11111
11112  21111
11111  11111
1111    1111
1111    1111



------------
121212121211
1          1
11 1 1 1 1 1
 1         1
1 1 1 1 1 11
1          1
11 1 1 1 1 1
            
11 12  21  1
11 1 11 1 11
22   22   22
1 1  11  1 1
221 1111 122
211 1111 112
     11     
            
1111    1111
11111 111111
11111  11111
111111 11111
11111  11111
11111 111111
1111   11111
1111 1 11111
11112   1111
1111111  111
11111111 111
111  12  111
111  11 1111
111  11 1111
111  11 1111
111     1111
11111 111111
1111  111111
111  1111111
111 11111111
111   111111
11111  11111
1111    1111
1111 11 1111
1111    1111
11   11   11
11  1111  11
11  1111  11
11  2112  11
11  2222  11
11 111111 11
11  1111  11
111 1111 111
111 1  1 111
111 1111 111
111 2  2 111
11  1  1  11
12  2  2  21
11  1111  11
11 2 11 2 11
1  1 11 1 11
1 11 11 1  1
1 12 11 11 1
1 112    1 1
1 111111 1 1
1 111   21 1
1  11 111  1
11  1  1  11
112      211
11111  11111
1111  111111
1111    1111
11111  11111
111111 21111
11111  11111
11111 111111
11111 111111
11111   1111
1111111 1111
1111111  111
11111111 111
11111111 111
1111111  111
111111 2  11
111111 11 11
111111  2 11
111111 11 11
111111 2  11
111111 11 11
111111  2 11
1111111  111
1111111  211
11111   1111
1111  211111
1111  111111
1111  111111
   11  11   
   1    1    
   1 11 1   
1111 11 1111
111      111
11 211112 11
11        11
111  11  111
1111    1111
111  11  111
111  11  111
111  11  111
111 1111 111
111  21  111
111      111
11111  11111
11 2    2 11
11 11  11 11
11 1    1 11
11 2 11 2 11
11 1 11 1 11
11 1    1 11
11 1 11 1 11
11   11   11
11   11   11
111 1111 111
111 1  1 111
111 1111 111
111  11  111
111 2112 111
111 1111 111
111  11  111
1111    1111
11111  11111
11112  21111
11111  11111
1111  111111
11112  11111
111111 11111
1111   11111
1111  111111
111  1111111
111   211111
112   111111
1    1111111
  11  111111
 1111  11111
  1111 11111
1  111  1111
11  111  111
111  111  11
1111  111   
11111 11111 
11111   1   
1111111 1 11
11111   1  1
11112  111 1
1111 1 11 21
1112 1   211
1111    1111
1111 11 1111
1111 11 1111
1111  2 1111
111  11  111
111  2   111
111      111
            
            
            
            
            
            
            
            
            
            
            