------------

11111  11111
            
  o   o   o 
112 0 2 0 21
2 o   o   o2
112 0 2 0 21
2 o 2 o 2 o2
1 2 0 2 0 21
11   111 111
11 1  2  111
            
11111111  11
111111   111
11111  11111
1111  111111
11   1111111
11 111111111
11   1111111
1111  111111
11111  11111
111111011111
11111    111
111111 1 111
1111   1   1
111111   111
111111   111
11111111  11
     11  11 
    11  11  
   11  11   
  11  11    
  11 11     
  11 1111   
  11   11   
   111 11   
  11   11   
  11 1111   
 111 11     
11   1111111
1  1  111111
1o111 111111
1 111  11111
1 1111 11111
1 211  11111
11211 111111
11 1  111111
11 o 1111111
1111  111111
1111    1111
11   10   11
111 1221 111
11        11
11  1111  11
111  11  111
11  1111  11 
 11  11  11 
  11    11  
 11  11  11 
 11  11  11 
  11    11  
11111  11111
