------------
111111 11111
            
111211121111
            
11 111 1 11 
2         2
11  11   111
11         1
1111  111  1
 11    21 11
11111  11 11
1111  11  11
111  11  111
111 1111  11
111 1111 111
1   2111   1
1  111111  1
1    12    1
111 111 1111
111     1111
111  1  1111
111 111 1111
11  111  111
11 11111 111
11 11111 111
11  111  111
111 212 1111
11  111  111
11 11111 111
11  111  111
111 111 1111
111  2  1111
111 111 1111
111 111 1111
111 111 1111
111  1  1111
1111 2 11111
11   1   111
1   111   11
1  11111  11
1 1111111  1
1  11111  11
11 21112 111
1  11111   1
1 1111111  1
1  11111   1
1   111   11
11   1   111
1111   11111
1111    1111
111111  1111
1111    1111
111  1111111
111  1111111
111     1111
111 211 1111
111  12 1111
111     1111
111  11  111
111  112 111
111      111
111 211  111
111  11  111
111  11  211
111  11   11
111 1111  11
11  1111   1
11 111111  1
11 111111  1
112  1111121
1111 11    1
1111 11 1111
1111 11 1111
1111    1111
1111  111111
1111   11111
1111 1111111
1111  111111
11111  21111
11111 111111
11111 111111
11111 111111
11111 111111
1112  111111
111  1111111
111  2 11111
1111 1 11111
1111 1 11111
1111 2 11111
11111  11111
11111  11111
11111  11111
111111 11111
111111 11111
11112  11111
1111   11111
1111112 1111
1111111 1111
1111111 1111
1111111   11
1111111 1 11
11111   1 11
11111 111 11
111     1211
111211    11
111  2  1211
111 111 1 11
111 111 1 11
111  1  1 11
111  1  1 11
1111 1 11 11
1111 2 11211
11111 111 11
11111     11
11111 111111
11111 111111
11111 111111
111   111111
111  1111111
111  1111111
1111  111111
1111  111111
11111 111111
11111  11111
1111   2 111
111   11 111
111 1  1 111
111211 12111
111      111
11111  11111
1111    1111
1111 11 1111
1111    1111
11111  11111
11112  21111
11111  11111
1111    1111
1111    1111
            
            
            
            
            
            
            
            
            
            
            