          1111111111111111111-
1111111111   v 2   2   v   111
1 11111111 111111111111111 111
1 1     1  1   ^       ^   111
1 1 v ^ 1  1 11111 11111 1 111
1 1 111 1  1 1   1 1   1 1 111
1 1     1  1 1 v 1 1 v 1 1 111
1 1111111 111 1 1 1 1 1 1 1111
1   2     1   1 1 1 1 1 1   11
111111 1111 111 1 1 1 1 111111
1111   1       1 1 1 1       1
1111 ^ 1 1111111 1 1 1 11111 1
1111   1 1       1 1 1 1     1
11111111 1 1111111 1 1 1 11111
11111111 1    v    1 1   v  11
1      1 1111111111 1111111 11
1 1111 1 1    2    1       211
1 1  1 1 1 1111111 1 1111 1111
1 1v 1 1 1 1     1 1 1 1  1111
1 1  1 1 1 1 v ^ 1 1 1 1^ 1111
1 1111 1 1 1111111 1 1111 1111
1      1 1         1       111
11111111 111111111111111111111
111111111111111111111111111111
1                             1
1                             1
111111111111111111111111111111
